20 28
40 20
00 00 00 00 00 00 00 00 00 00 00 00 00 00 00 00 00 00 00 00
00 00 00 00 00 00 00 00 00 00 00 00 00 00 00 00 00 00 00 00
00 00 01 01 01 01 01 01 01 01 01 01 01 01 01 01 01 00 00 00
00 00 01 01 02 02 02 02 02 02 02 02 02 02 02 01 01 00 00 00
00 00 01 01 02 03 03 03 03 03 03 03 03 03 02 01 01 00 00 00
00 00 01 01 02 03 04 04 04 04 04 04 04 03 02 01 01 00 00 00
00 00 01 01 02 03 04 04 04 04 04 04 04 03 02 01 01 00 00 00
00 00 01 01 02 03 03 03 03 03 03 03 03 03 02 01 01 00 00 00
00 00 01 01 02 02 02 02 02 02 02 02 02 02 02 01 01 00 00 00
00 00 01 01 01 01 01 01 01 01 01 01 01 01 01 01 01 00 00 00
00 00 00 00 00 00 01 01 01 01 01 01 01 00 00 00 00 00 00 00
00 00 00 00 00 00 00 02 02 02 02 02 00 00 00 00 00 00 00 00
00 00 00 00 00 00 00 00 03 03 03 00 00 00 00 00 00 00 00 00
00 00 00 00 00 00 00 00 00 04 00 00 00 00 00 00 00 00 00 00
00 00 00 00 00 00 00 00 00 00 00 00 00 00 00 00 00 00 00 00
00 00 00 00 00 00 00 00 00 00 00 00 00 00 00 00 00 00 00 00
00 00 00 00 00 00 00 00 00 00 00 00 00 00 00 00 00 00 00 00
00 00 00 00 00 00 00 00 00 00 00 00 00 00 00 00 00 00 00 00
00 00 00 00 00 00 00 00 00 00 00 00 00 00 00 00 00 00 00 00
00 00 00 00 00 00 00 00 00 00 00 00 00 00 00 00 00 00 00 00
00 00 00 00 00 00 00 00 00 00 00 00 00 00 00 00 00 00 00 00
00 00 00 00 00 00 00 00 00 00 00 00 00 00 00 00 00 00 00 00
00 00 00 00 00 00 00 00 00 00 00 00 00 00 00 00 00 00 00 00
00 00 00 00 00 00 00 00 00 00 00 00 00 00 00 00 00 00 00 00
00 00 00 00 00 00 00 00 00 00 00 00 00 00 00 00 00 00 00 00
00 00 00 00 00 00 00 00 00 00 00 00 00 00 00 00 00 00 00 00
00 00 00 00 00 00 00 00 00 00 00 00 00 00 00 00 00 00 00 00
